width: 40
height: 15
---
xxxxxxxxxxxxxxxxxxxxxxxxxxxxxxxxxxxxxxxx
x  *               S     x             x
x   v    O               x    *   *    x
x                      * x             x
x                  xxxxxxx        O   sx
x     xxx *   xx        v              x
x            B               xxx       x
x            xxxxxxxxxx        x       x
x         *     O              x   *   x
x      S              S     *  x       x
x  *  ^         *                      x
x                  O       v      O    x
x P   xx     s        xs               x
x         *           x       *        x
xxxxxxxxxxxxxxxxxxxxxxxxxxxxxxxxxxxxxxxx
---
